1111111111611211111
1166661110000200001
1166661110111266101
1222222110111266101
1111111110000200001
1300000000111111111
1011111660111111111
1011111660111116661
1000000000611116661
6111111111111111111
